..........................
..........................
..........................
..........................
.#@@...@@.....@@....#...@.
..@...@..@...@..@...#...@.
..@..#....@.@....@..#...@.
..@.#......@......@.#...@.
..@.#.............@.#...@.
..@.#.............@.#...@.
..@..#...........@..#...@.
..@...@.........@...#...@.
..@....@.......@....#...@.
..@.....@.....@.....#...@.
..@......@...@......#...@.
..@.......@.@.......#...@.
.#@@.......@.........@@@..
..........................
..........................
..........................
..........................
..........................
..........................
...........####...........
...........#..#...........
...........#..#...........
